0000000000000
0000001110000
0000001410000
0001111310000
0001423511100
0001113234100
0000012111100
0000014100000
0000011100000
0000000000000