0011111111100
0012211222100
0012223222100
0013211123100
0012244412100
0112224412110
0123222223210
0122222122510
0111111111110
0000000000000
